Specifications
Mileage
EPA Fuel Economy Est - Hwy : MPG	25
Cruising Range - City : mi	286.20
EPA Fuel Economy Est - City : MPG	18
Fuel Economy Est-Combined : MPG	20
Cruising Range - Hwy : mi	397.50
EPA MPG Equivalent - City :	N/A
EPA MPG Equivalent - Hwy :	N/A
EPA MPG Equivalent - Combined :	N/A
Battery Range : mi	N/A
Fuel Tank
Fuel Tank Capacity, Approx : gal	15.9
Aux Fuel Tank Capacity, Approx : gal	N/A
Cargo Area Dimensions
Trunk Volume : ft³	11
Brakes
Brake Type :	4-Wheel Disc
Brake ABS System :	4-Wheel
Brake ABS System (Second Line) :	N/A
Disc - Front (Yes or ) :	Yes
Disc - Rear (Yes or ) :	Yes
Front Brake Rotor Diam x Thickness : in	15
Rear Brake Rotor Diam x Thickness : in	14.6
Drum - Rear (Yes or ) :	
Rear Drum Diam x Width : in	
Emissions
Tons/yr of CO2 Emissions @ 15K mi/year :	8.8
EPA Greenhouse Gas Score :	N/A
Transmission
Drivetrain :	Rear Wheel Drive
Trans Order Code :	ZMT
Trans Type :	6
Trans Description Cont. :	Manual w/OD
Trans Description Cont. Again :	
First Gear Ratio (:1) :	4.11
Second Gear Ratio (:1) :	2.32
Third Gear Ratio (:1) :	1.54
Fourth Gear Ratio (:1) :	1.18
Fifth Gear Ratio (:1) :	1.00
Sixth Gear Ratio (:1) :	0.85
Reverse Ratio (:1) :	3.73
Clutch Size : in	N/A
Final Drive Axle Ratio (:1) :	3.46
Vehicle
EPA Classification :	Subcompact Cars
Interior Dimensions
Passenger Capacity :	4
Passenger Volume : ft³	N/A
Front Head Room : in	39.8
Front Leg Room : in	42.2
Front Shoulder Room : in	55.3
Front Hip Room : in	N/A
Second Head Room : in	36.1
Second Leg Room : in	33.7
Second Shoulder Room : in	51.7
Second Hip Room : in	N/A
Weight Information
Base Curb Weight : lbs	3625
Trailering
Dead Weight Hitch - Max Trailer Wt. : lbs	N/A
Dead Weight Hitch - Max Tongue Wt. : lbs	N/A
Wt Distributing Hitch - Max Trailer Wt. : lbs	N/A
Wt Distributing Hitch - Max Tongue Wt. : lbs	N/A
Engine
Engine Order Code :	
Engine Type :	Twin Turbo Premium Unleaded I-6
Displacement :	3.0 L/182
Fuel System :	Gasoline Direct Injection
SAE Net Horsepower @ RPM :	425 @ 5500
SAE Net Torque @ RPM :	406 @ 1850
Electrical
Cold Cranking Amps @ 0° F (Primary) :	900
Maximum Alternator Capacity (amps) :	210
Cooling System
Total Cooling System Capacity : qts	N/A
Suspension
Suspension Type - Front :	Strut
Suspension Type - Rear :	Multi-Link
Suspension Type - Front (Cont.) :	Strut
Suspension Type - Rear (Cont.) :	Multi-Link
Shock Absorber Diameter - Front : mm	N/A
Shock Absorber Diameter - Rear : mm	N/A
Stabilizer Bar Diameter - Front : in	N/A
Stabilizer Bar Diameter - Rear : in	N/A
Tires
Front Tire Order Code :	
Rear Tire Order Code :	
Spare Tire Order Code :	
Front Tire Size :	P255/40YR18
Rear Tire Size :	P275/40YR18
Spare Tire Size :	
Wheels
Front Wheel Size : in	18 X 9
Rear Wheel Size : in	18 X 10
Spare Wheel Size : in	
Front Wheel Material :	Forged Aluminum
Rear Wheel Material :	Forged Aluminum
Spare Wheel Material :	
Steering
Steering Type :	Rack-Pinion
Steering Ratio (:1), Overall :	N/A
Lock to Lock Turns (Steering) :	N/A
Turning Diameter - Curb to Curb : ft	40
Turning Diameter - Wall to Wall : ft	N/A
Exterior Dimensions
Wheelbase : in	110.7
Length, Overall : in	184.5
Width, Max w/o mirrors : in	79.3
Height, Overall : in	54.4
Track Width, Front : in	62.2
Track Width, Rear : in	63.1
Min  Ground Clearance : in	N/A
Liftover Height : in	N/A